Bezeichnung Auftragskonto;IBAN Auftragskonto;BIC Auftragskonto;Bankname Auftragskonto;Buchungstag;Valutadatum;Name Zahlungsbeteiligter;IBAN Zahlungsbeteiligter;BIC (SWIFT-Code) Zahlungsbeteiligter;Buchungstext;Verwendungszweck;Betrag;Waehrung;Saldo nach Buchung;Bemerkung;Kategorie;Steuerrelevant;Glaeubiger ID;Mandatsreferenz
VR-Komfort;DE33670923000033108036;GENODE61WNM;VOLKSBANK KURPFALZ;30.08.2024;31.08.2024;;;;ABSCHLUSS;Abschluss per 31.08.2024;-13,90;EUR;22421,32;;Sonstiges;;;
VR-Komfort;DE33670923000033108036;GENODE61WNM;VOLKSBANK KURPFALZ;30.08.2024;30.08.2024;Lastschrift aus Kartenzahlung;DE46370100500018299505;PBNKDEFFXXX;Basislastschrift;ALLDRINK GMBH/Heidelberg/DE29.08.2024 um 12:35:28 Uhr 68052603/182831/ECTL/      67092300/0033108036/0/1224;-20,94;EUR;22435,22;;Sonstiges;;DE26CPG00000000180;OFFLINE
VR-Komfort;DE33670923000033108036;GENODE61WNM;VOLKSBANK KURPFALZ;30.08.2024;30.08.2024;Bundeskasse - Dienstort Trier -;DE81590000000059001020;MARKDEF1590;Gehalt;Zahltag Versorgung 09-202403141003-2024-45012908-041914 EREF: 03141003-2024-45012908-041914;3300,58;EUR;22456,16;;Sonstiges;;;
VR-Komfort;DE33670923000033108036;GENODE61WNM;VOLKSBANK KURPFALZ;30.08.2024;30.08.2024;Deutsche Post AG NL Renten Service;DE55300600100000130171;GENODEDDXXX;Gehalt;66519094270190103 VBL-RENTE 09.2024 BRUTTORENTE  721,70 KV-BEITRAG  88,82 PV-BEITRAG 24,54 EREF: PANR66519094270190103;608,34;EUR;19155,58;;Sonstiges;;;
VR-Komfort;DE33670923000033108036;GENODE61WNM;VOLKSBANK KURPFALZ;30.08.2024;30.08.2024;Deutsche Post AG NL Renten Service;DE55300600100000130171;GENODEDDXXX;Gehalt;97061310339W00011 RV-RENTE  08.2024 EREF: PANR97061310339W00011;155,61;EUR;18547,24;;Sonstiges;;;
VR-Komfort;DE33670923000033108036;GENODE61WNM;VOLKSBANK KURPFALZ;30.08.2024;30.08.2024;Deutsche Post AG NL Renten Service;DE55300600100000130171;GENODEDDXXX;Gehalt;97061190942D50911 RV-RENTE  08.2024 EREF: PANR97061190942D50911;1633,97;EUR;18391,63;;Sonstiges;;;
